{
  "playerStartX": 5,
  "playerStartY": 5,
  "layout": [
    [" ", " ", " ", " ", " ", "O", " ", " ", " ", " ", " "],
    [" ", " ", " ", " ", " ", " ", " ", " ", " ", " ", " "],
    [" ", " ", " ", " ", "#", "#", "#", " ", " ", " ", " "],
    [" ", " ", " ", " ", " ", " ", " ", " ", " ", " ", " "],
    [" ", " ", "#", " ", " ", " ", " ", " ", "#", " ", " "],
    [" ", " ", "#", " ", " ", " ", " ", " ", "#", " ", " "],
    [" ", " ", "#", " ", " ", " ", " ", " ", "#", " ", " "],
    [" ", " ", " ", " ", " ", " ", " ", " ", " ", " ", " "],
    [" ", " ", " ", " ", "#", "#", "#", " ", " ", " ", " "],
    [" ", " ", " ", " ", " ", " ", " ", " ", " ", " ", " "],
    [" ", " ", " ", " ", " ", " ", " ", " ", " ", " ", " "]
  ]
}
